14,14,20,150
1,1,1,1,1,1,1,1
GGGGGGGGGGGGGG
GGPGGGGGGGGGGG
GGPPPPGGGGPPPG
GGPGGGGPPGPGPG
GGPGGGGPPPPGGG
GGGPPPGGGGGGGG
GGPPGPGGGGGGGG
GGPGPPPGGGPPPG
GGPGGGPPPPPGGG
GGPGGGPGGGGGGG
GGPGGGPGGGGGGG
GGGGGGGGGGGGGG
GGGGGGGGGGGGGG
GGGGGGGGGGGGGG
(M,1,0,0,0,0,0)
