16,8,20,150
30,30,30,30,30,30,30,30
GGGGGGGGGGGGGGGG
GPPPPPPPPPPPPPPG
GGPPGPPPPPGPPPGG
GGPPGPPGPPGGPGGG
GGPPGPGGGPGPGPGG
GGGPGPGPGPGPPPGG
GPPPPPPPPPPPPPPG
GGGGGGGGGGGGGGGG
(f,2,0,0,7,4,1,0)
