16,14,20,150
6000,3000,3000,2000,2000,2000,5000,8000
GGGGGGGGGGGGGGGG
GGPPPPPPPPPPPPPG
GGPGGGGGGTGGGGTG
GPPGGGGGGTGGGGTG
GGPGGGPPPPPPPGTG
GGPTTTPGGGGGPGTG
GGPGGGPGGGGGPPPG
GPPGGGPGGGGGPGPG
GGPPPPPGGGGGPGPG
GGPGGGGGGGGGPGPG
GGPPPPPPPPPPPPPG
GPPGGPGGGGGGGGPG
GGPGGPPPPPPPPPPG
GGGGGGGGGGGGGGGG
(f,2,0,0,7,4,1,0)
(f,2,0,0,7,2,1,0)
(m,2,0,0,6,3,1,0)
(m,2,0,0,8,3,1,0)